%%%%%%%
%    *%
%%%   %
%P  %%%
%%%%%%%